+  +  +  +  +  +  +  +  +  +  +  +  +  +  +  +  +  +  +  +  +  +  +  +  +  +  +  +  +  +  +  +
                                                                                              
+  +  +  +  +  +  +  +  +  +  +  +  +  +  +  +  +  +  +  +  +  +  +  +  +  +  +  +  +  +  +  +
                                                                                              
+  +  +  +  +  +  +  +  +  +  +  +  +  +  +  +  +  +  +  +  +  +  +  +  +  +  +  +  +  +  +  +
                                                                                              
+  +  +  +  +  +  +  +  +  +  +  +  +  +  +  +  +  +  +  +  +  +  +  +  +  +  +  +  +  +  +  +
                                                                                              
+  +  +  +  +  +  +  +  +  +  +  +  +  +  +  +  +  +  +  +  +  +  +  +  +  +  +  +  +  +  +  +
                                                                                              
+  +  +  +  +  +  +  +  +  +  +  +  +  +  +  +  +  +  +  +--+--+--+--+--+--+  +  +  +  +  +  +
                                                         |                 |                  
+  +  +  +  +  +  +  +  +  +  +  +  +  +  +  +  +  +--+  +  +--+--+--+--+  +--+--+  +  +  +  +
                                                   |                       |     |            
+  +  +  +  +  +  +  +  +  +  +  +  +  +  +  +  +--+  +--+--+  +  +  +  +  +--+  +  +  +  +  +
                                                |        |                 |  |  |            
+  +  +  +  +  +  +  +  +  +  +  +  +  +  +  +--+  +--+  +--+--+--+  +  +  +--+  +  +  +  +  +
                                                                                 |            
+  +  +  +  +  +  +  +  +  +  +  +  +  +  +  +--+--+--+--+--+  +  +--+  +--+--+--+  +  +  +  +
                                                               |                              
+  +  +  +  +  +  +  +  +  +  +  +  +  +  +  +  +  +  +  +--+  +--+  +--+  +  +  +  +  +  +  +
                                                         |  |           |                     
+  +  +  +  +  +  +  +  +  +  +  +  +  +  +  +  +  +  +  +  +--+--+  +--+  +  +  +  +  +  +  +
                                                         |           |                        
+  +  +  +  +  +  +  +  +  +  +  +  +  +  +  +  +  +  +  +--+--+--+--+  +  +  +  +  +  +  +  +
                                                                                              
+  +  +  +  +  +  +  +  +  +  +  +  +  +  +  +  +  +  +  +  +  +  +  +  +  +  +  +  +  +  +  +
                                                                                              
+  +  +  +  +  +  +  +  +  +  +  +  +  +  +  +  +  +  +  +  +  +  +  +  +  +  +  +  +  +  +  +
                                                                                              
+  +  +  +  +  +  +  +  +  +  +  +  +  +  +  +  +  +  +  +  +  +  +  +  +  +  +  +  +  +  +  +
                                                                                              
+  +  +  +  +  +  +  +  +  +  +  +  +  +  +  +  +  +  +  +  +  +  +  +  +  +  +  +  +  +  +  +
                                                                                              
+  +  +  +  +  +  +  +  +  +  +  +  +  +  +  +  +  +  +  +  +  +  +  +  +  +  +  +  +  +  +  +