+  +  +  +  +  +  +  +  +  +  +  +  +  +  +  +  +  +  +  +  +  +  +  +  +  +  +  +  +  +  +  +
                                                                                              
+  +  +  +  +  +  +  +  +  +  +  +  +  +  +  +  +  +  +  +  +  +  +  +  +  +  +  +  +  +  +  +
                                                                                              
+  +  +  +  +  +  +  +  +  +  +  +  +  +  +  +  +  +  +  +  +  +  +  +  +  +  +  +  +  +  +  +
                                                                                              
+  +  +  +  +  +  +  +  +  +  +  +  +  +  +  +  +  +  +  +  +  +  +  +  +  +  +  +  +  +  +  +
                                                                                              
+  +  +  +  +  +  +  +  +  +  +  +  +  +  +  +  +  +  +  +  +  +  +  +  +  +  +  +  +  +  +  +
                                                                                              
+  +  +  +  +  +  +  +  +  +  +  +  +  +  +  +  +  +  +  +--+--+--+--+--+--+  +  +  +  +  +  +
                                                         | * *  *  *  *  * |                  
+  +  +  +  +  +  +  +  +  +  +  +  +  +  +  +  +  +--+  +  +--+--+--+--+  +--+--+  +  +  +  +
                                                   | * *  *              * | * * |            
+  +  +  +  +  +  +  +  +  +  +  +  +  +  +  +  +--+  +--+--+  +  +  +  +  +--+  +  +  +  +  +
                                                | * *  * |               * | *| *|            
+  +  +  +  +  +  +  +  +  +  +  +  +  +  +  +--+  +--+  +--+--+--+  +  +  +--+  +  +  +  +  +
                                              *  *  *  *  *  *  *  *  *  *  *  * |            
+  +  +  +  +  +  +  +  +  +  +  +  +  +  +  +--+--+--+--+--+  +  +--+  +--+--+--+  +  +  +  +
                                                             * |                              
+  +  +  +  +  +  +  +  +  +  +  +  +  +  +  +  +  +  +  +--+  +--+  +--+  +  +  +  +  +  +  +
                                                         | *| * *  *  * |                     
+  +  +  +  +  +  +  +  +  +  +  +  +  +  +  +  +  +  +  +  +--+--+  +--+  +  +  +  +  +  +  +
                                                          *  *  *  * |                        
+  +  +  +  +  +  +  +  +  +  +  +  +  +  +  +  +  +  +  +--+--+--+--+  +  +  +  +  +  +  +  +
                                                                                              
+  +  +  +  +  +  +  +  +  +  +  +  +  +  +  +  +  +  +  +  +  +  +  +  +  +  +  +  +  +  +  +
                                                                                              
+  +  +  +  +  +  +  +  +  +  +  +  +  +  +  +  +  +  +  +  +  +  +  +  +  +  +  +  +  +  +  +
                                                                                              
+  +  +  +  +  +  +  +  +  +  +  +  +  +  +  +  +  +  +  +  +  +  +  +  +  +  +  +  +  +  +  +
                                                                                              
+  +  +  +  +  +  +  +  +  +  +  +  +  +  +  +  +  +  +  +  +  +  +  +  +  +  +  +  +  +  +  +
                                                                                              
+  +  +  +  +  +  +  +  +  +  +  +  +  +  +  +  +  +  +  +  +  +  +  +  +  +  +  +  +  +  +  +